AcademicDegreeTypes: TenantId (int), Id (int), ArabicName (nvarchar), EnglishName (nvarchar)
AcademicDegrees: TenantId (int), Id (int), Major (nvarchar), University (nvarchar), Notes (nvarchar), EmployeeId (int), AcademicDegreeTypeId (int), GradeId (int), DegreeDate (datetime)
Activities: TenantId (int), Id (int), Name (nvarchar), Code (nvarchar), ItemId (int), Effect (float), ItemEquationId (int), ValueActivityId (int), IsSingleRecord (bit)
ActivityAlerts: TenantId (int), Id (int), ActivityId (int), AlertTypes (int)
Addresses: TenantId (int), Id (int), AddressText (nvarchar), POBox (nvarchar), ZipCode (nvarchar), AddressType (nvarchar), DistrictId (int), EmployeeId (int)
AppVersions: Id (int), ReleaseTitle (nvarchar), ReleaseDate (datetime), ReleaseArabic (nvarchar), ReleaseEnglish (nvarchar), ReleaseApp (int), TenantId (int)
AppraisalGrades: TenantId (int), Id (int), From (float), To (float), Description (nvarchar), ArabicName (nvarchar), EnglishName (nvarchar)
AppraisalSchedules: TenantId (int), Id (int), Period (int), Start (varchar), Duration (int)
AspNetRoles: Id (nvarchar), Name (nvarchar), Description (nvarchar), Action (tinyint), Discriminator (nvarchar)
AspNetUserClaims: Id (int), UserId (nvarchar), ClaimType (nvarchar), ClaimValue (nvarchar)
AspNetUserLogins: UserId (nvarchar), LoginProvider (nvarchar), ProviderKey (nvarchar)
AspNetUserRoles: UserId (nvarchar), RoleId (nvarchar)
AspNetUsers: Id (nvarchar), UserName (nvarchar), PasswordHash (nvarchar), SecurityStamp (nvarchar), LegacyPasswordHash (nvarchar), LoweredUserName (nvarchar), MobileAlias (nvarchar), IsAnonymous (bit), LastActivityDate (datetime2), MobilePIN (nvarchar), Email (nvarchar), LoweredEmail (nvarchar), PasswordQuestion (nvarchar), PasswordAnswer (nvarchar), IsApproved (bit), IsLockedOut (bit), CreateDate (datetime2), LastLoginDate (datetime2), LastPasswordChangedDate (datetime2), LastLockoutDate (datetime2), FailedPasswordAttemptCount (int), FailedPasswordAttemptWindowStart (datetime2), FailedPasswordAnswerAttemptCount (int), FailedPasswordAnswerAttemptWindowStart (datetime2), Comment (ntext), EmailConfirmed (bit), PhoneNumber (nvarchar), PhoneNumberConfirmed (bit), TwoFactorEnabled (bit), LockoutEndDateUtc (datetime), LockoutEnabled (bit), AccessFailedCount (int), FirstLoginDate (datetime2), IsEnabled (bit), IsAdmin (bit), UserType (tinyint)
BalanceSettlements: TenantId (int), Id (int), Action (tinyint), Balance (float), Date (date), VacationBalanceId (int), BalanceBefore (float), TotalBalanceBefore (float), LastDate (date), EmployeeActivityId (int)
Banks: TenantId (int), Id (int), ArabicName (nvarchar), EnglishName (nvarchar)
BodyDetails: TenantId (int), Id (int), height (float), weight (float), ChestWidth (float), HeightHarmonyId (int), WeightHarmonyId (int), SkinColorId (int)
Branches: TenantId (int), Id (int), ArabicName (nvarchar), EnglishName (nvarchar), BankId (int), Adress (nvarchar), SwiftCode (nvarchar)
CIBBanks: TenantId (int), Id (int), Narrative (nvarchar), Currency (nvarchar), CreditorBICCode (nvarchar), AccountNumber (nvarchar), AccountName (nvarchar)
CRMActivities: Id (int), Action (nvarchar), Date (date), By (nvarchar), Result (nvarchar), CustomerId (int), Done (bit)
CRMBackups: TenantId (int), BackUpDbEvery (smallint), LastDbBackupDate (datetime), BackupFilesEvery (smallint), LastFilesBackupDate (datetime)
CRMContacts: Id (int), Name (nvarchar), Role (nvarchar), Email (nvarchar), Phone (nvarchar), Notes (nvarchar), Blog (bit), CustomerId (int)
CRMCustomers: Id (int), CompanyName (nvarchar), Country (nvarchar), State (nvarchar), Address (nvarchar), CreatedDate (datetime), Email (nvarchar), Mobile (nvarchar), CompanyField (nvarchar), Admin (nvarchar), RegistrationReasonId (int), OtherRegistrationReason (nvarchar), KnowUsFrom (int), Tag (nvarchar), Name (nvarchar), Paying (bit), TenantName (nvarchar), TenantId (int), ExpirationDate (datetime), UsersNumber (int), Status (int), SalesMan (nvarchar), Channels (int), Password (nvarchar), JobTitle (tinyint), ModulePriority (nvarchar), DecisionMaking (bit), EgyptionCompany (bit)
CRMPayments: Id (int), CustomerId (int), Date (datetime), Duration (int), Currency (int), Method (int), Amount (money), Rate (decimal), Notes (nvarchar)
CRMStages: Id (int), StatusId (int), Owner (nvarchar)
CRMStatuses: Id (int), Title (nvarchar)
CitizensIdentifications: TenantId (int), Id (int), NationalId (nvarchar), EndDate (date), PassportNumber (nvarchar), PassportEndDate (date)
CompanyInfo: TenantId (int), Id (int), Name (nvarchar), Commercialrecord (nvarchar), Taxcard (nvarchar), officailName (nvarchar), LogoPath (nvarchar), HasLogo (bit), InfoJson (nvarchar), EmployeesCount (int)
CompanyLegalInfo: TenantId (int), Id (int), CompanyName (nvarchar), CompanyInsuranceNumber (nvarchar), CommercialRecordNumber (nvarchar), CommercialRecordProcessNumber (nvarchar), InsuranceOfficeName (nvarchar), OwnerName (nvarchar), CompanyLegalForm (nvarchar), Governorate (nvarchar), Department (nvarchar), Village (nvarchar), StreetName (nvarchar), BuildingNumber (nvarchar), SickPercent (int), SickStartDate (datetime), InjuryPercent (int), InjuryStartDate (datetime), StopDate (datetime), StopReason (nvarchar), ResumeDate (datetime)
ContactTypes: TenantId (int), Id (int), ArabicName (nvarchar), EnglishName (nvarchar)
Contacts: TenantId (int), Id (int), Notes (nvarchar), ContactText (nvarchar), ContactTypeId (int), EmployeeId (int)
Contracts: TenantId (int), Id (int), StartDate (datetime), EndDate (datetime), EndReason (nvarchar), CreateDate (datetime), UserName (nvarchar), EmployeeId (int), Notes (nvarchar), IsPending (bit), AlertsHandled (bit), SignOff (bit), SettleDues (bit), AssignItems (bit)
Countries: TenantId (int), Id (int), ArabicName (nvarchar), EnglishName (nvarchar), ISOCode (nvarchar)
Custodies: TenantId (int), Id (int), Code (nvarchar), Description (nvarchar), Status (int), OtherStatus (nvarchar), Value (int), ItemId (int), CustodyTypeId (int), Available (bit)
CustodyTypes: TenantId (int), Id (int), ArabicName (nvarchar), EnglishName (nvarchar), Category (int), OtherType (nvarchar)
CustomFunctions: Id (int), EnglishName (nvarchar), ArabicName (nvarchar), Value (nvarchar), ArabicDescription (ntext), EnglishDescription (ntext)
Defendants: TenantId (int), Id (int), InvestigationId (int), EmployeeId (int)
Delegations: TenantId (int), Id (int), EmployeeId (int), DepartmentId (int), JobTitleId (int), StartDate (datetime), EndDate (datetime), ModifiedBy (nvarchar), ModifiedDate (datetime), ReplacedEmployeeId (int), UserType (tinyint)
DepartmentJobTitles: TenantId (int), Id (int), DepartmentId (int), JobTitleId (int), Number (int), IsHead (bit)
DepartmentTypes: TenantId (int), Id (int), ArabicName (nvarchar), EnglishName (nvarchar)
Departments: TenantId (int), Id (int), ArabicName (nvarchar), EnglishName (nvarchar), DepartmentTypeId (int), ParentId (int), IsHidden (bit)
Districts: TenantId (int), Id (int), ArabicName (nvarchar), EnglishName (nvarchar), GovernrateId (int)
DocumentTypes: TenantId (int), Id (int), ArabicName (nvarchar), EnglishName (nvarchar), Required (bit), IsHiring (bit), Type (tinyint)
Documents: TenantId (int), Id (int), SubmitDate (datetime), Required (bit), Received (bit), DocumentTypeId (int), EmployeeId (int), Note (nvarchar)
DrivingLicenses: TenantId (int), Id (int), Number (nvarchar), ReleaseDate (datetime), ExpirationDate (datetime), ViewPublication (nvarchar), LicenseTypeId (int)
EdaraTenants: TenantId (int), Token (nvarchar)
Emails: TenantId (int), Id (int), Host (nvarchar), Port (int), EmailAddress (nvarchar), Password (nvarchar), SslEnabled (bit), SendGrid (bit)
EmployeeActivities: TenantId (int), Id (int), ActivityId (int), Value (float), ExecutionDate (datetime), Comment (nvarchar), CreateDate (datetime), UserName (nvarchar), EmployeeId (int), SalaryItemId (int), ValueToCalculate (float), Tag (nvarchar), LoanId (int), ValueActivityId (int)
EmployeeAppraisals: TenantId (int), Id (int), Start (datetime), End (datetime), Value (float), EmployeeId (int), EmployeeEvaluationTemplateId (int), Duration (nvarchar), Feedback (nvarchar), DevPlan (nvarchar)
EmployeeBanks: TenantId (int), Id (int), BranchId (int), AccountNum (nvarchar), PplSoftId (nvarchar), AccountType (nvarchar)
EmployeeCodes: TenantId (int), Id (int), Length (tinyint), Prefix (nvarchar)
EmployeeCustodies: TenantId (int), Id (int), EmployeeId (int), CustodyId (int), DeliveryDate (datetime), DateOfReceipt (datetime), EmployeeActivityId (int)
EmployeeEvaluationTemplates: TenantId (int), Id (int), From (datetime), IsActive (bit), Employees (nvarchar), EvaluationTemplateId (int)
EmployeeEvaluations: TenantId (int), Id (int), EmployeeId (int), EvaluationTemplateId (int), TotalEvaluationValue (float), IsActive (bit), FlgStatus (bit)
EmployeeFaceIds: TenantId (int), Id (int), ImageUrl (varchar), IsApproved (bit), MasterFaceId (uniqueidentifier), FacePersonId (uniqueidentifier), FacePersonGroupId (nvarchar), Status (tinyint), RecognitionModel (nvarchar)
EmployeeGroupsEmployees: TenantId (int), EmployeeId (int), EmployeeGroupId (int)
EmployeeInsurances: TenantId (int), Id (int), EmployeeId (int), SocialNumber (nvarchar), Type (nvarchar), RegisterDate (datetime), BasicSalary (float), RegisterSalary (float), TotalSalary (float), MonthlyPercentage (float), QualificationName (nvarchar), Code1 (nvarchar), Code2 (nvarchar), JobTitle (nvarchar), Nationality (int), NationalId (nvarchar), PassportNumber (nvarchar), PermitStatus (int), PermitNumber (nvarchar), WorkingDuration (int)
EmployeeItems: TenantId (int), Id (int), ItemId (int), EquationId (int), Value (float), EmployeeId (int), ExpenseAccount (int), AccrualAccount (int), CostCenter (int)
EmployeeJobs: TenantId (int), Id (int), Code (varchar), ArabicName (nvarchar), EnglishName (nvarchar), Email (nvarchar), Status (tinyint), UserName (nvarchar), NationalId (nvarchar), HasImage (bit), ActualWorkingDate (datetime), DepartmentId (int), DepartmentArabicName (nvarchar), DepartmentEnglishName (nvarchar), JobTitleId (int), JobTitleArabicName (nvarchar), JobTitleEnglishName (nvarchar), IsHead (bit)
EmployeeLocations: TenantId (int), EmployeeId (int), LocationId (int), StartDate (date), EndDate (date)
EmployeeMultiPlans: TenantId (int), Id (int), EmployeeId (int), PlanId (int), FromDate (datetime), ToDate (datetime), ModifiedDate (datetime), ModifiedBy (nvarchar)
EmployeePlans: TenantId (int), Id (int), FromDate (datetime), ToDate (datetime), EmployeeId (int), PlanId (int)
EmployeePortal: TenantId (int), Id (int)
EmployeeRequestReviewCycles: TenantId (int), EmployeeId (int), RequestReviewCycleId (int)
EmployeeRequests: Id (int), EmployeeId (int), RequestTypeId (int), TenantId (int)
EmployeeServices: TenantId (int), Id (int), EmployeeId (int), Service (nvarchar), Notes (nvarchar), BeforeDiscount (decimal), AfterDiscount (decimal), CreatedDate (datetime), EmployeeProviderId (int), ServiceProviderId (int)
EmployeeTimeTables: TenantId (int), EmployeeId (int), PlanDetailId (int), Date (date)
Employees: TenantId (int), Id (int), ModifiedDate (datetime), Email (nvarchar), Active (bit), UserName (nvarchar), PicPath (nvarchar), NationalId (nvarchar), ModifiedBy (nvarchar), BirthDate (datetime), ArabicFirstName (nvarchar), ArabicSecondName (nvarchar), ArabicFamilyName (nvarchar), EnglishFirstName (nvarchar), EnglishSecondName (nvarchar), EnglishFamilyName (nvarchar), BloodGroup (nchar), MaritalDate (datetime), Code (nvarchar), SubjectToInsurance (bit), SocialId (nvarchar), MaritalStatusId (int), ReligionId (int), GenderId (int), CountryId (int), ExtendedData (nvarchar), Phone (nvarchar), EmergencyNumber (nvarchar), EmployeeBankId (int), OtherReligion (nvarchar), Notes (nvarchar), IsTrusted (bit), HasEpAccount (bit), HasImage (bit), ArabicName (nvarchar), EnglishName (nvarchar), EssPassword (nchar), WowDeskId (int), IsSuspended (bit)
EmployeesDashboard: TenantId (int), Id (int), EmployeesCount (int), SystemHealth (float), EmployeeStored (int), EmployeePercentage (float), UndeliverdDoc (int), BasicData (varchar), JobData (varchar), TurnoverMeter3Mon (float), TurnoverMeter6Mon (float), TurnoverMeter12Mon (float), LeavingEmployeesCount3 (int), LeavingEmployeesCount12 (int), NewEmployeesCount12 (int), Vacancy (int), JobTitleCount (int), Citizens (float), BirthDateThisMonth (int), LastUpdate (datetime)
EmployeesGroups: TenantId (int), Id (int), ArabicName (nvarchar), EnglishName (nvarchar), GroupTypes (int)
Equations: TenantId (int), Id (int), Name (nvarchar), Code (nvarchar), Text (nvarchar), ItemId (int), ExcOrder (int), Type (nvarchar), IsDefault (bit), Description (nvarchar), IsArchived (bit)
EssSettings: TenantId (int), Id (int), EnableEssEmployeeEdit (bit), PrintAttendance (bit), EnableTimeSheet (bit), FinancialRequestId (int), OnlyByDayVacation (bit)
EvaluationTemplateKPIs: TenantId (int), EvaluationTemplateId (int), KPIId (int), Weight (float)
EvaluationTemplates: TenantId (int), Id (int), Code (int), ArabicName (nvarchar), EnglishName (nvarchar), Period (int), Type (tinyint), Description (nvarchar), IsActive (bit), Categories (nvarchar)
Evaluations: TenantId (int), Id (int), EmployeeEvaluationId (int), KPIId (int), FromDate (datetime), EvaluationValue (float), PercentageWeight (float), ToDate (datetime)
Evaluators: TenantId (int), Id (int), EmployeeId (int), JobTitleId (int), DepartmentId (int), Boss (int), Order (tinyint), Kpis (nvarchar), EmployeeEvaluationTemplateId (int)
Events: TenantId (int), Id (int), EventName (nvarchar), EventRec (int), EventDate (datetime), FontColor (nvarchar), BackgroundColor (nvarchar), EventNameEn (nvarchar)
ExperienceValues: TenantId (int), Id (int), Value (float), Year (int), RankId (int)
Experiences: TenantId (int), Id (int), PreviousPosition (nvarchar), StartDate (datetime), EndDate (datetime), Organization (nvarchar), Notes (nvarchar), EmployeeId (int)
ExtraWorkingTimes: TenantId (int), Id (int), ArabicName (nvarchar), EnglishName (nvarchar)
ExtraWorkings: TenantId (int), Id (int), DurationFrom (nchar), DurationTo (nchar), Hours (int), FormDeliveryDate (datetime), Date (datetime), EmployeeId (int), ExtraWorkingTimeId (int)
FamilyMembers: TenantId (int), Id (int), ArabicName (nvarchar), BirthDate (datetime), EmployeeId (int), RelationTypeId (int), MaritalStatus (nvarchar), EnglishName (nvarchar), IdNumber (varchar), RelationDate (date), CountryId (int)
Files: TenantId (int), Id (int), Path (nvarchar), IsDocument (bit), EmployeeId (int), DocumentTypeId (int), IsAttached (bit)
Footers: TenantId (int), Id (int), ArabicTemplate (nvarchar), EnglishTemplate (nvarchar)
FormDataHistories: TenantId (int), Id (int), Url (nvarchar), FormData (ntext), Username (nvarchar)
FormalVacations: TenantId (int), Id (int), StartDate (datetime), Title (nvarchar), EndDate (datetime), IsAllDay (bit), StartTime (time), EndTime (time)
Genders: TenantId (int), Id (int), ArabicName (nvarchar), EnglishName (nvarchar)
Governrates: TenantId (int), Id (int), ArabicName (nvarchar), EnglishName (nvarchar), CountryId (int)
Grades: TenantId (int), Id (int), ArabicName (nvarchar), EnglishName (nvarchar)
HSBCSettings: TenantId (int), Id (int), PaymentType (nvarchar), DebitAccountNumber (nvarchar), DebitAccountCountry (nvarchar), DebitAccountCurrency (nvarchar), TransactionCurrency (nvarchar), BeneCountryCode (nvarchar), SecondPartyReference (nvarchar), LCCCode (nvarchar)
HeightHarmonies: TenantId (int), Id (int), ArabicName (nvarchar), EnglishName (nvarchar)
HireTypes: TenantId (int), Id (int), ArabicName (nvarchar), EnglishName (nvarchar)
Holidays: TenantId (int), Id (int), ArabicName (nvarchar), BDate (datetime), Days (int), EnglishName (nvarchar)
Identifications: TenantId (int), Id (int), ResidenceNumber (nvarchar), PassportNumber (nvarchar), ResidenceEndDate (datetime), PassportEndDate (datetime)
Identities: TenantId (int), Id (int), TableName (nvarchar), TableId (int)
ImportantDates: TenantId (int), Id (int), EventName (nvarchar), DateTime (datetime), EmployeeId (int), SystemCalender (bit), EmployeePortal (bit)
InsuranceDocuments: TenantId (int), Id (int), InstitutionNumber (int), Area (nvarchar), Office (nvarchar), InstitutionName (nvarchar), Owner (nvarchar), DirectorInCharge (nvarchar), PropertyID (int), StreetName (nvarchar), Xiahe (nvarchar), Village (nvarchar), Section (nvarchar), Station (nvarchar), Governorate (nvarchar), StopDate (datetime), ContinueDate (datetime), StopReason (nvarchar), StartActivity (nvarchar), InstitutionLegalForm (nvarchar)
InsuranceEmployeeSalaries: TenantId (int), Id (int), EmployeeId (int), BasicItemId (int), SubscriptionItemId (int), TotalItemId (int), BasicValue (decimal), SubscriptionValue (decimal), TotalValue (decimal)
InsuranceLimits: Id (int), Year (int), MinBasicSalary (float), MaxBasicSalary (float), MinSubscriptionFee (float), MaxSubscriptionFee (float), RetirementAge (int), LastModifiedDate (datetime)
InsuranceOfficeEmployees: TenantId (int), Id (int), EmployeeId (int), InsuranceOfficeId (int)
InsuranceOffices: TenantId (int), Id (int), OfficeName (nvarchar)
InsuranceTypes: TenantId (int), Id (int), ArabicName (nvarchar), EnglishName (nvarchar), DeductionOfBasicSalary (float), DeductionOfVariableSalary (float)
Insurances: TenantId (int), Id (int), Date (datetime), BasicSalary (float), VariableSalary (float), InsuranceType_Id (int), SubscriptionFee (float), Minimum (float), Maximum (float), Retirementage (float), LastModifiedDate (float)
IntegrationTransactions: Id (int), ActivityId (int), TransactionType (nvarchar), IsOvertime (bit), LastReadingDate (datetime), TenantId (int)
Investigations: TenantId (int), Id (int), Number (nvarchar), Date (datetime), Subject (nvarchar), Result (nvarchar), ViolationId (int)
Investigators: TenantId (int), Id (int), InvestigationId (int), EmployeeId (int)
ItemEffects: TenantId (int), Id (int), ArName (nvarchar), EnName (nvarchar)
ItemPackages: TenantId (int), Id (int), ArabicName (nvarchar), EnglishName (nvarchar)
Items: TenantId (int), Id (int), Name (nvarchar), DefaultValue (float), MeasureUnitId (int), ItemEffectId (int), Code (nvarchar), CalculatedBy (nvarchar), ExpenseAccount (int), AccrualAccount (int), CostCenter (int), ShowOnPaySlip (bit)
JobAreaDepartments: TenantId (int), DepartmentId (int), JobAreaId (int)
JobAreaKpis: TenantId (int), KpiId (int), JobAreaId (int)
JobAreas: TenantId (int), Id (int), ArabicName (nvarchar), EnglishName (nvarchar)
JobHistories: TenantId (int), Id (int), DecreeNo (nvarchar), DecreeFromDate (datetime), EmployeeId (int), DepartmentId (int), JobTitleId (int), JobTypeId (int), HireTypeId (int), SalaryGrade (nvarchar), DecreeToDate (datetime), StartDate (datetime), EndDate (datetime), ContractStartDate (datetime), ContractEndDate (datetime), Note (nvarchar)
JobHistoryLogs: TenantId (int), Id (int), EmployeeId (int), DepartmentId (int), JobTitleId (int), JobTypeId (int), ActualWorkingDate (datetime), StartDate (datetime), EndDate (datetime), ContractStartDate (datetime), ContractEndDate (datetime), UserAction (tinyint), ModifiedDate (datetime), ModifiedBy (nvarchar), Note (ntext)
JobTitleItemPackages: TenantId (int), Id (int), ItemPackageId (int), JobTitleId (int), DepartmentId (int)
JobTitlePlans: TenantId (int), Id (int), PlanId (int), JobTitleId (int), DepartmentId (int)
JobTitleVacationTypes: TenantId (int), Id (int), VacationTypeId (int), JobTitleId (int), DepartmentId (int)
JobTitles: TenantId (int), Id (int), ArabicName (nvarchar), EnglishName (nvarchar), Description (nvarchar), Code (nvarchar)
JobTypes: TenantId (int), Id (int), ArabicName (nvarchar), EnglishName (nvarchar)
Jobs: TenantId (int), Id (int), CommitteeNo (nvarchar), CommitteeDate (datetime), DecreeNo (nvarchar), DecreeDate (datetime), ContractStartDate (datetime), ContractEndDate (datetime), ActualWorkingDate (datetime), RatePerHour (float), MonthlySalary (float), DepartmentId (int), JobTitleId (int), HireTypeId (int), JobTypeId (int), SkillId (int), ExperienceValueId (int), RankId (int), VacationStartDate (datetime), TestEndDate (datetime), IsHead (bit), HourlyRate (float), ModifiedDate (datetime), ModifiedBy (nvarchar), Note (nvarchar), ActualEndDate (datetime)
KPIs: TenantId (int), Id (int), EnglishName (nvarchar), ArabicName (nvarchar), Period (int), IsActive (bit), JobAreaId (int), CategoryId (int), Type (tinyint), Description (nvarchar)
KpiCategories: TenantId (int), Id (int), ArabicName (nvarchar), EnglishName (nvarchar), Period (int), IsActive (bit), Description (nvarchar)
KpiEvaluations: TenantId (int), Id (int), KpiId (int), EvaluatorId (int), Weight (float), Value (float), EmployeeAppraisalId (int), Feedback (nvarchar), DevPlan (nvarchar)
KpiJobTitles: TenantId (int), Id (int), KpiId (int), JobTitleId (int), DepartmentId (int)
LicenseTypes: TenantId (int), Id (int), ArabicName (nvarchar), EnglishName (nvarchar)
LoanSettings: TenantId (int), Id (int), ActivityId (int)
LoanSkippedMonths: TenantId (int), Id (int), LoanId (int), Month (date)
LoanTypeEmployees: TenantId (int), EmployeeId (int), LoanTypeId (int)
LoanTypes: TenantId (int), Id (int), ArabicName (nvarchar), EnglishName (nvarchar), Type (tinyint), DurationBeforeDeserve (smallint), MaxNoOfPayments (smallint), AllowMultiple (bit), Percentage (float), ItemId (int), ActivityId (int), ExpenseAccount (int), AccrualAccount (int), CostCenter (int), CalculateCurrentSalary (bit)
Loans: TenantId (int), Id (int), EmployeeId (int), LoanTypeId (int), Date (date), Value (float), StartDate (date), Installments (int), IsRequest (bit), IsCanceled (bit), Notes (nvarchar), JournalCode (nvarchar), RequestId (int)
Locations: TenantId (int), Id (int), ArabicName (nvarchar), EnglishName (nvarchar), Latitude (float), Longitude (float), DistanceRangeInMeters (float), TimeZoneId (varchar)
MachineCommands: TenantId (int), Id (int), SerialNumber (nvarchar), Command (nvarchar), Status (tinyint)
MachinePushApiSettings: TenantId (int), MachineId (int), Stamp (int), Delay (int), Encrypt (int), ErrorDelay (int), OpStamp (int), Realtime (int), TransFlag (nvarchar), TransInterval (int), TransTimes (nvarchar), TimeZone (int)
MachineSdkSettings: TenantId (int), MachineId (int), IP (nvarchar), Port (int), Password (nvarchar), IsBlackAndWhite (bit), MachineBrand (int)
Machines: TenantId (int), Id (int), Name (nvarchar), SerialNumber (nvarchar), Stamp (int), Delay (int), Encrypt (int), ErrorDelay (int), OpStamp (int), Realtime (int), TransFlag (nvarchar), TransInterval (int), TransTimes (nvarchar), TimeZone (int), MachineUploadMethod (tinyint), UseTransactionType (bit), TransactionType (tinyint)
ManualVacationBalances: TenantId (int), Id (int), Value (int), Date (datetime), UserName (nvarchar), VacationBalanceId (int), Type (nvarchar)
MaritalStatuses: TenantId (int), Id (int), ArabicName (nvarchar), EnglishName (nvarchar)
MeasureUnitTypes: TenantId (int), Id (int), ArName (nvarchar), EnName (nvarchar)
MeasureUnits: TenantId (int), Id (int), ArName (nvarchar), EnName (nvarchar), MeasureUnitTypeId (int)
Militaries: TenantId (int), Id (int), Note (nvarchar), EndDate (datetime), StatusDate (datetime), MilitaryStatusId (int), MilitaryRenewalDate (datetime)
MilitaryStatus: TenantId (int), Id (int), ArabicName (nvarchar), EnglishName (nvarchar)
MissionTypes: TenantId (int), Id (int), ArabicName (nvarchar), EnglishName (nvarchar)
Missions: TenantId (int), Id (int), From (datetime), To (datetime), Destination (nvarchar), EmployeeId (int), IsRequest (bit), IsCanceled (bit), IsApproved (bit), Unit (tinyint), Notes (nvarchar), RequestId (int), TimeTables (varchar), ModifiedBy (nvarchar), ModifyDate (datetime)
MobileAppSettings: TenantId (int), Id (int), ImageVerificationMode (tinyint), LocationVerificationMode (tinyint)
MobileTransactionPools: TenantId (int), Id (int), Time (datetime), Type (nvarchar), EmployeeId (int), IsTrusted (bit), Latitude (float), Longitude (float), Guid (uniqueidentifier), LocationId (int), VerificationStatus (int), Username (nvarchar), UnverfiedMasterImageUrl (nvarchar), IsApproved (bit)
MonthlyTimeSheets: TenantId (int), Id (int), Value (float), Note (nvarchar), Date (datetime), EmployeeId (int), IsSubmitted (bit)
Nationalities: TenantId (int), Id (int), ArabicName (nvarchar), EnglishName (nvarchar)
Notifications: TenantId (int), Id (int), Date (datetime), Title (nvarchar), Details (ntext), Notes (ntext), EmployeeId (int), IsCanceled (bit), Seen (bit), CancellationReason (nvarchar), EmployeeActivityId (int), Attachments (nvarchar)
OracleIntegrationErrors: Id (int), TenantId (int), EntityName (int), Error (nvarchar), Date (datetime), EmployeeCode (nvarchar), IntegrationDate (datetime), TransactionCode (bigint)
OracleIntegrationServiceLoggers: Id (int), TenantId (int), Status (bit), Username (nvarchar), Date (datetime)
OracleIntegrationServices: Id (int), TenantId (int), ServiceStatus (bit)
OracleIntegrations: TenantId (int), Id (int), MohrId (int), OracleId (nvarchar), EntityName (int), LastModificationDate (datetime), GroupId (nvarchar), AssignmentId (nvarchar), IsDeleted (bit), IsLocked (bit)
OrganizationSettings: TenantId (int), Id (int), AutoSubscriptionFee (bit), ItemId (int)
PackageItems: TenantId (int), Id (int), ItemId (int), EquationId (int), Value (float), ItemPackageId (int), ExpenseAccount (int), AccrualAccount (int), CostCenter (int)
PayrollSettings: TenantId (int), Id (int), SubscriptionFeeItemId (int), ShowActivities (bit), SalaryCalculationStartDay (int), HideNetSalaryFromESS (bit)
Penalties: TenantId (int), Id (int), ArabicName (nvarchar), EnglishName (nvarchar), DeductedAmount (float)
PenaltyReasons: TenantId (int), Id (int), ArabicName (nvarchar), EnglishName (nvarchar)
PermissionSettings: TenantId (int), Id (int), NumberPerMonth (tinyint), Duration (int), PermissionType (tinyint), IsAllowed (bit)
Permissions: TenantId (int), Id (int), PermissionType (tinyint), Date (date), IsRequest (bit), EmployeeId (int), Notes (ntext), IsCanceled (bit), Duration (int), From (time), To (time), PlanDetailId (int), RequestId (int), ModifiedBy (nvarchar), ModifyDate (datetime), FromDate (datetime), ToDate (datetime)
PlanDetails: TenantId (int), Id (int), Date (datetime), AttendStart (time), AttendExact (time), AttendEnd (time), LeaveStart (time), LeaveExact (time), LeaveEnd (time), PlanId (int), TimeTableId (nvarchar), IsAbsenceChecked (bit), IsLeaveChecked (bit), Border (time), IsVacation (bit), IsExtended (bit), MinWorkingHours (float), MaxWorkingHours (float), ShiftSettingId (int), MaxOvertime (float)
PlanFormalVacations: TenantId (int), Id (int), PlanId (int), FormalVacationId (int), StartDate (datetime), EndDate (datetime), Title (nvarchar)
PlanShifts: TenantId (int), Id (int), PlanId (int), ShiftId (int), ShiftStartDate (datetime), ShiftEndDate (datetime)
Plans: TenantId (int), Id (int), Name (nvarchar), StartDate (datetime), EndDate (datetime), ShiftId (int), ModifiedDate (datetime), ModifiedBy (nvarchar)
ProjectEmployees: TenantId (int), ProjectId (int), EmployeeId (int), HourlyRate (float)
Projects: TenantId (int), Id (int), Code (nvarchar), ArabicName (nvarchar), EnglishName (nvarchar), Description (nvarchar), ManagerId (int), IsActive (bit), StartDate (datetime), EndDate (datetime), WowDeskId (int)
QualificationTypes: TenantId (int), Id (int), ArabicName (nvarchar), EnglishName (nvarchar)
Qualifications: TenantId (int), Id (int), Date (datetime), GradeId (int), QualificationTypeId (int), EmployeeId (int)
Query: TenantId (int), Id (int), ActivityId (int), Value (float), ExecutionDate (datetime2), Comment (ntext), CreateDate (datetime2), UserName (ntext), EmployeeId (int), SalaryItemId (int), ValueToCalculate (float)
Ranks: TenantId (int), Id (int), ArabicName (nvarchar), EnglishName (nvarchar), CategoryNo (int), BasicSalary (float), InsuranceBasicSalary (float), InsuranceVariableSalary (float)
RelationTypes: TenantId (int), Id (int), ArabicName (nvarchar), EnglishName (nvarchar), GenderId (int)
Religions: TenantId (int), Id (int), ArabicName (nvarchar), EnglishName (nvarchar)
ReportFooters: TenantId (int), Id (int), FooterId (int), Report (nvarchar)
RequestReviewCycles: TenantId (int), Id (int), ArabicName (nvarchar), EnglishName (nvarchar), RequestType (tinyint), IsDefault (bit), RequestedId (int), SingleApprovalEnabled (bit)
RequestReviewers: TenantId (int), Id (int), RequestId (int), EmployeeId (int), IsApproved (bit), Reason (nvarchar), Order (tinyint), IsCurrent (bit), ModifiedDate (datetime), ModifiedBy (nvarchar), SingleApprovalEnabled (bit)
RequestTypes: TenantId (int), Id (int), ArabicName (nvarchar), EnglishName (nvarchar), Type (tinyint), IsEditable (bit), ActivityId (int), IsEditableByEmployee (bit), DefaultValue (float)
Requests: TenantId (int), Id (int), Date (datetime), EmployeeId (int), RequestType (tinyint), IsApproved (bit), IsCanceled (bit), Notes (nvarchar), ModifiedDate (datetime), ModifiedBy (nvarchar), Guid (uniqueidentifier), RequestTypeId (int), Value (float), IsDelivered (bit), DeliveryNotes (nvarchar), Attachments (nvarchar), CreatedDate (datetime), RefId (int), MonthlyTimeSheet_Id (int)
RequestsTypes: Id (int), arabicname (nvarchar), englishname (nvarchar)
Reviewers: TenantId (int), Id (int), EmployeeId (int), JobTitleId (int), DepartmentId (int), Boss (int), RequestReviewCycleId (int), Order (tinyint), RequestType (tinyint), RequestedId (int), SingleApprovalEnabled (bit)
Salaries: TenantId (int), Id (int), EmployeeId (int), CreateDate (datetime), IsPaid (bit), Month (int), Year (int), From (datetime), To (datetime), Label (nvarchar), Value (float), PaidAmount (float), IsDelivered (bit), JournalCode (nvarchar), NeedRecalculation (bit)
SalaryItems: TenantId (int), Id (int), ItemId (int), Value (float), EquationText (nvarchar), SalaryId (int), IsActivityItem (bit), EquationName (nvarchar), ExpenseAccount (int), AccrualAccount (int), CostCenter (int), IsDelivered (bit), JournalCode (nvarchar)
SalarySettings: TenantId (int), Id (int), Type (int), IsManual (bit), ItemId (int)
ServiceProviders: Id (int), CustomerName (nvarchar), Services (nvarchar), Country (nvarchar), Description (ntext), ImagePath (ntext)
Settings: TenantId (int), Id (int), VacationServiceEnable (bit), AbsenceServiceEnable (bit), PermissionStratDay (int), AlertCalculatedFromExacttime (bit), EarlyAttend (tinyint), LateAttend (tinyint), EarlyLeave (tinyint), LateLeave (tinyint), EmailsLanguage (tinyint), CanUploadMasterImage (bit), AllowedRequestTypes (nvarchar), WorkingHoursFrom (tinyint), WorkingHoursTo (tinyint), BasicSalaryItemId (int), VariableSalaryItemId (int), AttendanceServiceEnable (bit), MobileAppEnabled (bit), ManagerPortalEnabled (bit), OkrEnabled (bit), MobileAppUserCount (int), SubscriptionFeeItemId (int), ShowActivities (bit), ModifiedBy (nvarchar), ModifiedDate (datetime), AlertCalculatedFromExacttimeDay (int)
SettlementTypes: TenantId (int), Id (int), ArabicName (nvarchar), EnglishName (nvarchar)
Sheet1$: Code (nvarchar), Email (nvarchar)
ShiftSettings: TenantId (int), Id (int), ShiftType (int), CheckForAbsence (bit), WorkingHoursPerMonth (int), ActivityId (int), RaiseVacationAlerts (bit), FreeShiftTypePredicationMethod (tinyint), OverWriteEarlyLeave (bit)
Shifts: TenantId (int), Id (int), Cycles (int), StartDay (int), ArabicName (nvarchar), EnglishName (nvarchar), ShiftType (int), ShiftSettingId (int), ShiftUnit (int), ModifiedBy (nvarchar), ModifiedDate (datetime), Notes (nvarchar)
Skills: TenantId (int), Id (int), Value (float), Description (nvarchar), Name (nvarchar)
SkinColors: TenantId (int), Id (int), ArabicName (nvarchar), EnglishName (nvarchar)
SocialInsuranceSettings: TenantId (int), Id (int), AutoSubscriptionFee (bit), ItemId (int)
Suspensions: TenantId (int), Id (int), EmployeeId (int), StartDate (datetime), EndDate (datetime), Reason (nvarchar), MobileAppDisabled (bit), IsCanceled (bit), CreatedBy (nvarchar), CreatedDate (datetime), EndedBy (nvarchar), EndedDate (datetime)
TaskEmployees: TenantId (int), TaskId (int), EmployeeId (int), StartDate (datetime), EndDate (datetime), HourlyRate (float)
Tasks: TenantId (int), Id (int), Code (int), Name (nvarchar), Description (nvarchar), IsActive (bit), IsPublic (bit), StartDate (datetime), EndDate (datetime), ProjectId (int), WowDeskId (int)
TempEmployees: Id (int), Email (nvarchar)
TenantRequestTypes: Id (int), RequestType (tinyint), CustomerId (int), TenantId (int)
Tenants: TenantId (int), SellerName (nvarchar), Name (nvarchar), Status (nvarchar), Modules (int), ExpirationDate (datetime), UsersNumber (int)
TimeSheet: TenantId (int), Id (int), StartDate (datetime), Duration (float), TaskId (int), ProjectId (int), EmployeeId (int), WowDeskId (int)
TimeTables: TenantId (int), Id (int), AttendBegin (time), AttendTime (time), AttendEnd (time), LeaveBegin (time), LeaveTime (time), LeaveEnd (time), ShiftDay (smallint), ShiftId (int), Border (time), IsVacation (bit), IsExtended (bit), MinWorkingHours (float), TimeTableOrder (int), MaxWorkingHours (float), ModifiedBy (nvarchar), ModifiedDate (datetime), MaxOvertime (float)
TransactionAlertHandlings: TenantId (int), Id (int), Date (datetime), Note (nvarchar), HandlerType (tinyint), HandlingId (int), UserId (nvarchar), TransactionAlertId (int), IsCanceled (bit), Value (float)
TransactionAlerts: TenantId (int), Id (int), AlertType (int), TransactionId (int), IsHandled (bit), Count (int), Duration (float), HandledDuration (float), Handlers (varchar), From (bigint), To (bigint)
TransactionPools: TenantId (int), Id (int), Code (nvarchar), Time (datetime), Type (nvarchar), MachineName (nvarchar), Username (nvarchar), Reason (tinyint)
Transactions: TenantId (int), Id (int), TransDateTime (datetime), Type (nvarchar), EmployeeId (int), PlanDetailId (int), IsManual (bit), TimeTableId (nvarchar), Username (nvarchar), Tag (nvarchar), Notes (nvarchar), HasAlerts (bit), IsTrusted (bit), Latitude (float), Longitude (float), LocationId (int), Source (tinyint), CreatedDate (datetime), ImageUrl (nvarchar), IsSaved (bit), MobileNotes (nvarchar)
UserEmployees: TenantId (int), Id (int), UserName (nvarchar), EmployeeId (int), Module (tinyint), Exclusive (bit)
UserLogs: TenantId (int), Id (int), UserName (nvarchar), EmployeeId (int), UserAction (tinyint), EntityName (nvarchar), Date (datetime), Details (nvarchar), RefId (int)
UserScenarios: TenantId (int), Id (int), ActionType (int), ElementId (nvarchar), ElementType (nvarchar), ElementValue (nvarchar), TimeStamp (datetime), UserName (nvarchar)
VacationBalanceLogs: TenantId (int), Id (int), EmployeeId (int), VacationTypeId (int), Balance (float), Times (int), Action (tinyint), ModifiedBy (nvarchar), ModifiedDate (datetime), Reason (nvarchar)
VacationBalances: TenantId (int), Id (int), EmployeeId (int), VacationTypeId (int), Balance (float), Times (int), LastDate (datetime), ModifiedBy (nvarchar), ModifiedDate (datetime)
VacationSettings: TenantId (int), Id (int), BalanceStart (int), BalanceAddedEvery (int), ExpiredBalanceHandling (int), TransferLimit (int), AfterReachLimit (int), DaysTransferLimitFinal (int), ExpiredItemId (int), VacationOnAccount (bit), DaysTransferLimit (int), BalanceTransferVacationTypeId (int), BalanceAddedFromVacationTypeId (int), SavingVacationWay (int)
VacationSettlements: TenantId (int), Id (int), Action (tinyint), Balance (float), Date (date), VacationBalanceId (int), BalanceBefore (float), BalanceTransferVacationTypeId (int), TotalBalanceBefore (float), LastDate (date)
VacationTypeEmployees: TenantId (int), EmployeeId (int), VacationTypeId (int)
VacationTypeUpdates: TenantId (int), Id (int), OldVacationTypeId (int), NewVacationTypeId (int), ChangeOn (tinyint), Years (tinyint)
VacationTypes: TenantId (int), Id (int), ArabicName (nvarchar), EnglishName (nvarchar), Balance (int), Payed (int), DurationBeforeDeserve (int), Limit (int), Type (tinyint), RequiredAttachment (bit), HideBalance (bit), AddOfficialVacations (bit), AddWeekendVacations (bit), MaximumMonthsForFutureDedution (int), Day (bit), HalfDay (bit), QuarterDay (bit)
Vacations: TenantId (int), Id (int), FromDate (datetime), ToDate (datetime), Duration (float), EmployeeId (int), Note (nvarchar), VacationTypeId (int), ReviewerId (int), ReplacementId (int), IsCanceled (bit), ModifiedBy (nvarchar), ModifiedDate (datetime), Alerts (ntext), Notified (bit), DocumentId (int), RequestId (int), Tag (nvarchar), AnotherTypeBalance (float), TimeTables (varchar), ReplacementChecked (bit)
ViolationTypes: TenantId (int), Id (int), ArabicName (nvarchar), EnglishName (nvarchar)
Violations: TenantId (int), Id (int), ViolationDate (datetime), Note (nvarchar), PenaltyDate (datetime), DeductedAmount (float), Applied (bit), ViolationTypeId (int), EmployeeId (int), PenaltyId (int), AppliedById (int)
Weapons: TenantId (int), Id (int), LicenseNo (nvarchar), Type (nvarchar), Number (int), LicenseStartDate (datetime), LicenseEndDate (datetime)
WearDetails: TenantId (int), Id (int), Trousers (nvarchar), Jacket (nvarchar), Shirt (nvarchar), shoes (nvarchar)
WeightHarmonies: TenantId (int), Id (int), ArabicName (nvarchar), EnglishName (nvarchar)
WowDeskAccounts: TenantId (int), Id (int), ClientName (nvarchar), UserName (nvarchar), Password (nvarchar), Token (nvarchar)
vanEmployees: TenantId (int), Id (int), ModifiedDate (datetime), Email (nvarchar), Active (bit), UserName (nvarchar), PicPath (nvarchar), NationalId (nvarchar), ModifiedBy (nvarchar), BirthDate (datetime), ArabicFirstName (nvarchar), ArabicSecondName (nvarchar), ArabicFamilyName (nvarchar), EnglishFirstName (nvarchar), EnglishSecondName (nvarchar), EnglishFamilyName (nvarchar), BloodGroup (nchar), MaritalDate (datetime), Code (nvarchar), SubjectToInsurance (bit), SocialId (nvarchar), MaritalStatusId (int), ReligionId (int), GenderId (int), CountryId (int), ExtendedData (nvarchar), Phone (nvarchar), EmergencyNumber (nvarchar), EmployeeBankId (int), OtherReligion (nvarchar), Notes (nvarchar), IsTrusted (bit), HasEpAccount (bit), HasImage (bit), ArabicName (nvarchar), EnglishName (nvarchar), EssPassword (nchar), WowDeskId (int), IsSuspended (bit)